Existence - Brigado Crew/MAC:ANNÂ
A Cappella - Goom Gum
In Your Mind (Original Mix) - Moonwalk
Endeavour - Yubik Remix - Denes Toth/Yubik
Legion - Goom Gum
Human Heart - Silver Panda
Reality (Original Mix) - Duohorses
Ana - Massano & Zafrir
Concorde (Original Version) - Miss Monique
Look At You (Original Mix)  - Miss Monique
Embrace (Extended Mix) - Q.U.A.K.E, Eli & Dani
Seva (Original Mix)  - Sounds of Rituals, Augusto Yepes, Darmon
We You (Adam Ten Extended Remix)  - Super Flu
Tell Me Why (MEDUZA Extended Remix)  - Supermode
Sweet Disposition (John Summit & Silver Panda Extended Remix)  - The Temper Trap
So Good - Tim Engelhardt, Sean Doron
Alright - Underspreche
Kiss Me Hard (Adam Ten Remix) - WhoMadeWho & Blue Hawaii
Kiss Me Hard (Innellea Remix)  - WhoMadeWho, Blue Hawaii
The Stars (DJEFF Remix)  - Xinobi, Meta_
Heartbeat (Extended Mix) - Yotto
Just Another Piano Track (Extended Mix) - Yotto
Summertime Sadness Feat. Blu - Zamna Soundsystem, Rozyo & Armonica
WILD ELECTRIC (Original Mix) - ADRIANNA
The Future Is Unknown  [X Recordings]_01 - Adriatique, Delhia De France - 
Beyond Us (Extended Hatshepsut Version, Alex Wann remix) - Adriatique, Eynka
Changing Colors (Extended Version) - Adriatique, Solique, ALSO ASTIR
Miracle - RÜFÜS DU SOL Remix  - Adriatique, WhoMadeWho, RÜFÜS DU SOL
Does It Matter (Ajna (BE) Remix)  - Ajna (BE), Samm (BE)
Move (Original Mix)  - Ajna (BE), Samm (BE)
Bubble (Original Mix)  - Ale F & Kari Bazzo
Milkshake (Original Mix)  - Alex Wann
Asa (Original Mix)  - Âme
Sacrifice (Extended Mix) [Afterlife Records] - Anyma (ofc) 
Aria (Extended Mix) - Argy, Omnya
Tainted Love (Extended Mix)  - Bassner
Transient (Extended) - Because of Art
Make Me Feel (feat. Iveta Mukuchyan) (Extended) - Bedouin
Fell In Luv (Black Circle Extended Remix)  - Carlita & Calussa
Born In Blue (Original Mix)  - Chambord, Jaguar Jaguar
Wet (Original Mix)  - deadmau5, testpilot
Nebula [Das Ohr Digital] - DIDI (DE)
She Likes (Original Mix) [Habitat Records] - Dyzen
Zizzy - Enamour
Turn On The Lights again.. (feat. Future) [Anyma Remix] (Extended) - Future, Swedish House Mafia, Fred again..
Slow Down (Extended Mix)  - GENESI
Give It To Me - MAT SA
TARAKA (Extended Mix) [Ultra] - Gordo - 
What To Do (&ME Remix)  - Guy Gerber
No Good [Rose Avenue] - Joe Mattei 
Sieders (Original Mix)  - Jos & Eli
Drowning (Extended Mix)  - KASIA
Sacrifice (Extended Mix) - Kaskade, deadmau5, Kx5
Dance with Me - Kevin de Vries
Metro (Extended Mix) - Kevin de Vries, Mau P
Sweet Surrender (Extended Mix)  - Korolova
Stolen Glances (feat. Låpsley Original Mix) - Låpsley, Franky Wah
House (Solomun Extended Remix)  - London Grammar
Pull Out (Original Mix)  - Losless, ARTBAT, KAS:ST
Alone Together - Maga, Tim Engelhardt
Always on My Mind - Mambo Brothers & Ben Westbeech
Remember the Music (Original Mix)  - Marco Faraone
I Will Find You (Extended Mix) [MHA] - Mathame
Fabric Of Existence (Extended Mix) - Max & Dana
See You Sweat (Original Mix)  - Max Styler, GENESI (ITA)
Dare Your Move (Extended Mix)  - Maxi Meraki
Friends (ARTBAT Remix Extended)  - Meduza
Love Seeking (Club Mix) [Life And Death] - Mind Against
More Love (Rampa &ME Remix) - Moderat, Keinemusik
Return to Oz (Artbat Remix) - Monolink
Never Ends ((MRAK & Omnya Remix) - Extended Mix) - Mrak
The World Is Yours (Extended Mix) - Mrak, Braev
Their Law (Extended Mix) - Mrak, David Lindmer
The Flame (Extended Mix) - Mrak, Wasiu, Braev
Endlessly (Original Mix)  - Nadia Ali, CamelPhat
Renegade (Adam Ten & Mita Gami Remix)  - Nicolas Masseyeff, Parallelle
Pretoria (Extended Mix) - Nora En Pure
Breathe You In feat. NORTH (Extended Mix)  - North, Gorgon City
Soda - Notre Dame
Is It Real (Tim Engelhardt & Sean Doron Remix) - Oliver Koletzki, Malou
Along Came Polly (Original Mix) - Rebūke
Twilight Language (Extended Version)  - Rodriguez Jr.
On My Knees (Cassian Remix) - RÜFÜS DU SOL
Losing My Religion (Extended Mix) - Samantha Loveridge, Treetalk
Astra (Sasha's Daydream Mix) - Sasha
Memoria (Original Mix)  - Sasha Carassi
Glastacy (Extended) - Sasha, Sentre
Astra (Original Mix) - Sasha, Super Flu
On The Low (Extended Mix) - SCRIPT (ofc)
Somebody (Original Mix) - Sebjak, Fahlberg
Tuxedo Park (Extended Mix) - Simon Doty, My Friend
Lost Control (Original Mix) - Son Of Son
